2 2 2 2 2 2 2 2 2 2 2 2 2 2 2
2 5 5 5 5 5 5 5 5 5 5 5 5 5 2
2 5 3 3 3 3 3 3 3 3 3 3 3 5 2
2 5 3 1 1 1 1 1 1 1 1 1 3 5 2
2 5 3 1 1 1 1 1 1 1 1 1 3 5 2
2 5 3 3 3 3 3 3 3 3 3 3 3 5 2
2 5 5 5 5 5 5 5 5 5 5 5 5 5 2
2 2 2 2 2 2 2 2 2 2 2 2 2 2 2
